2 2 2 2 2 2 2 2 2 2 2 2 2 2 2 2 2 2 2 2 2 2 2 2 2 2 2 2 2 2 2 2 2 2 2 2 2 2 2 2 2 2 2 2 2 2 2 2 2 2 2 2 2 2 2 2 2 2 2 2 2 2 2 2 2 2 2 2 2 2 2 2 2 2 2 2 2 2 2 2 2 2 2 2 2 2 2
2 2 2 2 2 2 2 2 2 2 2 2 2 2 2 2 2 2 2 2 2 2 2 2 2 2 2 2 2 2 2 2 2 2 2 2 2 2 2 2 2 2 2 2 2 2 2 2 2 2 2 2 2 2 2 2 2 2 2 2 2 2 2 2 2 2 2 2 2 2 2 2 2 2 2 2 2 2 2 2 2 2 2 2 2 2 2
2 2 2 2 2 2 2 2 2 2 2 2 2 2 2 2 2 2 2 2 2 2 2 2 2 2 2 2 2 2 2 2 2 2 2 2 2 2 2 2 2 2 2 2 2 2 2 2 2 2 2 2 2 2 2 2 2 2 2 2 2 2 2 2 2 2 2 2 2 2 2 2 2 2 2 2 2 2 2 2 2 2 2 2 2 2 2
2 2 2 2 2 2 2 2 2 2 2 2 2 2 2 2 2 2 2 2 2 2 2 2 2 2 2 2 2 2 2 2 2 2 2 2 2 2 2 2 2 2 2 2 2 2 2 2 2 2 2 2 2 2 2 2 2 2 2 2 2 2 2 2 2 2 2 2 2 2 2 2 2 2 2 2 2 2 2 2 2 2 2 2 2 2 2
2 2 2 2 2 2 2 2 2 2 2 2 2 2 2 2 2 2 2 2 2 2 2 2 2 2 2 2 2 2 2 2 2 2 2 2 2 2 2 2 2 2 2 2 2 2 2 2 2 2 2 2 2 2 2 2 2 2 2 2 2 2 2 2 2 2 2 2 2 2 2 2 2 2 2 2 2 2 2 2 2 2 2 2 2 2 2
2 2 2 2 2 2 2 2 2 2 2 2 2 2 2 2 2 2 2 2 2 2 2 2 2 2 2 2 2 2 2 2 2 2 2 2 2 2 2 2 2 2 2 2 2 2 2 2 2 2 2 2 2 2 2 2 2 2 2 2 2 2 2 2 2 2 2 2 2 2 2 2 2 2 2 2 2 2 2 2 2 2 2 2 2 2 2
2 2 2 2 2 2 2 1 3 3 3 46 47 3 3 3 3 3 3 3 3 3 3 3 3 3 3 3 3 3 3 3 3 3 3 3 3 3 78 0 0 0 4 4 0 0 4 0 0 0 4 0 0 0 0 0 4 4 0 0 0 4 0 0 0 0 0 0 0 4 4 0 6 0 0 0 4 4 0 0 5 2 2 2 2 2 2 
2 2 2 2 2 2 2 1 3 3 3 48 49 3 3 3 3 3 3 3 53 54 55 56 57 3 3 3 3 3 3 3 3 3 46 47 3 3 76 0 0 0 4 0 4 0 0 0 6 0 0 0 5 0 4 7 8 0 0 0 0 0 0 0 0 4 0 0 0 6 11 0 0 5 0 4 11 0 0 0 0 2 2 2 2 2 2
2 2 2 2 2 2 2 1 3 3 3 3 3 3 3 3 46 47 3 3 58 59 60 61 62 3 3 3 3 3 3 3 3 3 48 49 3 3 76 0 0 4 0 5 5 0 0 0 0 0 0 0 0 0 0 9 10 0 6 0 5 0 5 4 0 5 0 4 0 0 12 0 0 4 4 0 12 0 0 4 0 2 2 2 2 2 2
2 2 2 2 2 2 2 1 3 3 3 3 3 3 3 3 48 49 3 3 63 64 65 66 67 3 3 3 3 3 3 3 3 3 3 3 3 3 76 0 0 0 0 4 4 0 6 0 0 0 4 4 0 0 5 0 4 0 0 0 4 0 0 0 0 6 0 0 4 0 4 0 6 0 0 0 0 0 0 0 0 2 2 2 2 2 2
2 2 2 2 2 2 2 1 3 3 3 3 3 3 3 3 3 3 3 3 68 69 70 71 72 3 3 3 3 3 3 3 3 3 3 3 3 3 76 0 4 0 4 0 0 0 0 0 0 0 0 0 0 0 0 0 0 0 0 0 0 0 0 11 0 0 4 0 13 14 15 16 17 18 0 0 11 4 6 0 5 2 2 2 2 2 2
2 2 2 2 2 2 2 1 46 47 3 3 3 3 3 3 3 3 3 3 3 3 3 3 3 3 3 46 47 3 3 3 46 47 3 3 3 3 76 0 0 0 4 4 0 0 4 0 5 0 4 0 0 0 0 0 4 4 0 0 0 0 4 12 0 0 0 0 19 20 21 22 23 24 4 0 12 0 0 4 0 2 2 2 2 2 2
2 2 2 2 2 2 2 1 48 49 3 3 3 3 3 3 3 3 3 46 47 3 3 3 3 3 3 48 49 3 3 3 48 49 3 3 3 3 76 0 4 0 4 0 0 0 0 0 0 0 0 0 0 0 0 5 0 0 0 0 0 0 0 0 0 4 11 0 25 26 27 28 29 30 0 0 0 0 5 0 0 2 2 2 2 2 2
2 2 2 2 2 128 129 130 3 3 3 3 3 3 3 3 3 3 3 48 49 3 3 3 3 3 3 3 3 3 3 3 3 3 3 3 3 3 76 0 0 4 6 6 0 0 0 7 8 4 0 0 6 0 0 0 0 0 0 0 4 6 0 5 0 0 12 0 31 32 33 34 35 36 0 0 0 0 0 5 0 2 2 2 2 2 2
2 2 2 2 2 131 132 133 3 3 3 3 3 3 3 3 3 3 3 3 3 3 3 3 3 3 3 3 3 3 3 3 3 3 3 3 3 3 76 0 0 0 4 4 0 0 4 9 10 0 4 0 0 0 7 8 4 4 0 0 0 0 0 0 0 4 4 0 51 0 0 0 0 51 0 0 0 0 0 0 0 2 2 2 2 2 2
2 2 2 2 2 134 135 136 3 3 3 3 3 3 3 3 3 3 3 3 3 3 3 3 3 3 3 3 3 3 3 3 3 3 3 3 3 3 76 0 0 0 0 0 0 0 0 0 0 0 0 4 0 0 9 10 0 0 0 0 0 0 4 0 0 7 8 6 52 0 0 0 5 52 0 7 8 0 0 0 6 2 2 2 2 2 2
2 2 2 2 2 2 2 1 3 3 3 3 3 3 3 46 47 3 3 3 3 3 3 3 3 3 3 3 3 3 3 3 46 47 3 3 3 3 76 0 0 0 0 0 0 0 0 0 0 5 0 0 4 0 0 0 0 0 0 0 0 0 4 0 0 9 10 0 5 0 4 0 0 0 4 9 10 0 0 6 0 2 2 2 2 2 2
2 2 2 2 2 2 2 1 3 46 47 3 3 3 3 48 49 3 3 3 3 3 46 47 3 3 3 46 47 3 3 3 48 49 3 3 3 3 76 0 4 4 0 0 5 0 0 0 0 0 0 0 0 0 0 4 0 0 0 0 4 0 0 0 0 0 0 0 0 0 0 0 4 0 0 5 0 0 0 0 5 2 2 2 2 2 2
2 2 2 2 2 2 2 1 3 48 49 3 3 3 3 3 3 3 3 3 3 3 48 49 3 3 3 48 49 3 3 3 3 3 3 3 3 3 76 0 0 0 0 4 0 0 4 4 0 0 0 0 0 0 0 0 0 0 0 0 0 0 7 8 0 0 0 4 0 7 8 4 0 0 0 0 0 0 0 0 0 2 2 2 2 2 2
2 2 2 2 2 2 2 1 3 3 3 3 3 3 3 3 3 3 3 3 3 3 3 3 3 3 3 3 3 3 3 3 3 3 3 3 3 3 76 0 0 4 0 5 0 0 4 0 0 6 0 0 5 7 8 0 0 0 0 5 0 0 9 10 4 0 0 0 0 9 10 0 0 0 5 0 7 8 4 4 0 2 2 2 2 2 2
2 2 2 2 2 2 2 1 3 3 3 3 3 3 3 46 47 3 3 3 3 3 3 3 3 3 3 3 3 3 3 3 3 3 3 3 3 3 76 0 4 0 0 0 0 0 0 0 0 0 0 0 0 9 10 0 0 4 0 0 5 0 0 0 0 0 4 0 0 0 4 0 0 0 0 6 9 10 4 0 4 2 2 2 2 2 2
2 2 2 2 2 2 2 1 3 46 47 3 3 3 3 48 49 3 3 3 3 3 3 3 46 47 3 3 3 3 3 3 3 46 47 3 3 3 76 0 4 0 0 4 0 0 0 0 0 6 0 0 0 0 0 4 0 0 0 0 0 4 0 0 0 0 0 0 4 0 0 6 0 0 5 0 0 0 0 0 4 2 2 2 2 2 2
2 2 2 2 2 2 2 1 3 48 49 3 3 3 3 3 3 3 3 3 3 3 3 3 48 49 3 3 3 3 3 3 3 48 49 3 3 3 76 0 0 5 0 0 4 0 0 0 0 0 0 0 6 0 0 0 0 5 0 0 0 0 0 0 0 0 0 0 6 7 8 0 0 0 6 0 0 0 4 0 0 2 2 2 2 2 2
2 2 2 2 2 2 2 1 3 3 3 3 3 3 3 3 3 3 3 3 3 3 3 3 3 3 3 3 3 46 47 3 3 3 3 3 3 3 76 0 0 0 0 0 0 0 4 0 0 0 0 0 0 0 0 0 0 0 0 0 0 5 7 8 0 5 0 5 4 9 10 0 4 0 0 7 8 0 0 0 0 2 2 2 2 2 2
2 2 2 2 2 2 2 1 3 3 3 3 3 46 47 3 3 3 3 3 3 3 3 3 3 3 3 3 3 48 49 3 3 3 3 3 3 3 76 0 0 0 0 0 0 0 0 0 0 0 0 4 0 0 0 4 0 0 0 0 0 0 9 10 0 0 0 4 0 0 0 4 0 0 0 9 10 0 0 0 0 2 2 2 2 2 2
2 2 2 2 2 2 2 1 3 3 3 3 3 48 49 3 3 3 3 3 3 3 3 3 3 3 3 3 3 3 3 3 3 3 3 3 3 3 77 0 4 4 0 6 0 0 4 0 4 0 6 0 0 0 0 0 0 0 0 0 0 0 0 0 0 0 6 0 0 5 0 0 0 0 0 0 5 0 0 4 0 2 2 2 2 2 2
2 2 2 2 2 2 2 6 0 0 0 0 0 0 0 0 6 0 0 0 0 0 0 0 5 6 0 0 0 0 5 0 0 0 0 6 0 5 4 0 0 0 0 0 0 0 0 0 0 0 0 0 0 0 0 0 0 0 0 4 0 0 0 0 0 4 0 0 0 0 6 0 0 0 0 5 0 0 0 4 4 2 2 2 2 2 2
2 2 2 2 2 2 2 0 0 0 0 0 4 4 0 0 0 0 0 6 5 0 0 0 0 0 0 0 4 4 0 0 0 5 5 0 0 0 0 0 0 4 4 0 0 0 5 0 0 0 0 5 51 4 0 0 51 0 0 0 4 0 0 4 0 0 0 0 0 0 0 0 0 0 0 0 0 0 4 0 6 2 2 2 2 2 2
2 2 2 2 2 2 2 0 0 0 4 0 0 0 4 4 0 0 0 0 0 0 0 0 4 0 0 0 0 0 0 0 0 0 0 0 0 0 0 0 4 0 0 0 0 0 0 0 0 0 0 0 52 0 0 0 52 0 0 0 0 0 0 0 0 0 6 0 5 0 5 4 0 5 0 4 0 0 0 0 0 2 2 2 2 2 2
2 2 2 2 2 2 2 0 0 0 0 0 0 0 0 0 0 5 0 0 0 0 4 0 0 0 0 0 0 0 0 0 0 4 4 4 4 4 4 0 4 0 0 0 0 0 0 0 6 138 141 141 141 0 0 0 141 141 141 143 0 4 0 0 0 0 0 0 0 0 0 0 4 0 0 0 0 0 0 0 0 2 2 2 2 2 2
2 2 2 2 2 2 2 4 4 0 0 0 0 4 0 0 0 0 4 0 0 0 4 0 0 0 0 0 0 4 4 4 5 0 0 0 0 0 0 0 0 0 4 4 0 0 4 0 0 139 137 137 137 137 137 137 137 137 137 144 0 0 0 0 0 0 0 0 4 0 0 5 0 0 0 0 0 4 0 0 0 2 2 2 2 2 2
2 2 2 2 2 2 2 0 0 0 4 0 0 4 0 0 5 0 4 0 0 4 0 0 0 0 0 0 0 0 4 6 0 0 0 0 0 0 0 0 4 0 0 0 0 0 0 0 0 139 137 137 137 137 137 137 137 137 137 144 0 0 0 0 0 6 0 0 4 0 4 0 6 0 0 0 0 0 0 6 4 2 2 2 2 2 2
2 2 2 2 2 2 2 0 0 0 4 0 0 4 0 0 5 0 4 0 0 4 0 0 0 0 0 0 0 0 4 6 0 0 0 0 0 0 0 0 4 0 0 0 0 0 0 0 0 139 137 137 137 37 38 39 137 137 137 144 0 0 0 0 0 6 0 0 4 0 4 0 6 0 0 0 0 0 0 6 4 2 2 2 2 2 2
2 2 2 2 2 2 2 4 0 5 6 0 0 0 0 0 0 4 4 0 0 0 6 4 4 4 0 0 0 0 0 0 5 0 4 4 4 0 0 0 0 0 0 6 5 5 0 0 0 139 137 137 137 40 41 42 137 137 137 144 4 0 0 0 5 0 0 0 6 0 0 0 0 0 4 0 0 0 0 0 0 2 2 2 2 2 2
2 2 2 2 2 2 2 0 0 0 0 0 0 0 0 0 0 0 0 5 0 0 0 0 261 262 263 0 0 0 0 0 0 0 4 0 0 0 6 6 0 0 0 0 0 0 0 0 0 139 137 137 137 43 44 45 137 137 137 144 0 0 0 0 0 4 4 0 0 0 0 0 0 0 5 0 0 0 0 0 0 2 2 2 2 2 2
2 2 2 2 2 2 2 0 0 0 0 4 4 0 0 0 0 0 0 0 6 0 0 0 264 265 266 0 0 0 6 6 0 0 0 0 0 0 0 0 0 0 0 0 0 0 0 0 0 139 137 137 137 137 137 137 137 137 137 144 0 0 0 5 0 0 0 4 5 0 0 0 0 0 0 0 0 4 0 4 0 2 2 2 2 2 2
2 2 2 2 2 2 2 0 0 0 0 4 0 0 0 0 0 0 0 0 5 0 0 0 267 268 269 0 0 0 0 0 0 4 0 0 0 0 0 0 0 0 0 0 0 0 0 0 0 139 137 137 137 137 137 137 137 137 137 144 0 0 0 0 0 0 0 0 6 0 0 0 0 0 0 0 0 0 0 6 0 2 2 2 2 2 2
2 2 2 2 2 2 2 4 4 5 0 0 0 0 0 0 0 0 0 0 0 0 0 0 0 0 0 0 0 0 0 4 4 4 0 0 0 0 0 5 6 0 0 0 0 0 0 0 0 139 137 137 137 137 137 137 137 137 137 144 0 5 0 0 0 0 0 0 0 0 0 0 0 0 0 0 0 0 6 4 4 2 2 2 2 2 2
2 2 2 2 2 2 2 0 0 0 0 0 0 0 6 0 0 0 0 0 0 0 0 0 0 0 0 0 0 0 0 0 0 0 0 0 0 0 0 0 0 0 0 0 0 0 5 5 0 140 141 141 141 141 141 141 141 141 141 142 0 6 0 0 0 0 0 5 0 0 0 0 5 0 0 0 0 0 0 4 4 2 2 2 2 2 2
2 2 2 2 2 2 2 0 0 0 0 0 5 5 0 0 0 0 0 0 0 0 0 6 0 0 0 0 0 6 0 0 0 0 0 4 4 0 0 0 0 0 4 0 0 0 0 0 4 0 0 0 0 0 0 0 0 5 5 0 0 0 0 0 0 0 0 0 6 6 0 0 0 0 0 0 0 0 5 0 4 2 2 2 2 2 2
2 2 2 2 2 2 2 0 0 0 0 4 4 4 0 0 0 0 5 0 0 0 0 4 4 0 4 0 0 4 0 0 0 0 0 0 0 0 0 0 0 0 0 4 0 0 0 4 4 0 0 0 0 0 0 0 0 0 4 4 4 0 0 0 0 0 0 0 0 0 0 0 6 0 0 0 0 0 0 5 0 2 2 2 2 2 2
2 2 2 2 2 2 2 0 0 0 0 0 0 0 0 0 0 0 0 0 0 0 5 0 0 6 0 0 0 0 0 4 0 0 0 0 5 0 0 0 0 0 4 0 0 0 0 0 0 0 0 0 0 0 0 0 0 0 0 0 0 0 0 0 0 0 0 0 0 0 0 0 0 0 5 0 0 0 0 0 0 2 2 2 2 2 2
2 2 2 2 2 2 2 0 0 0 0 0 261 262 263 4 0 0 0 0 4 4 0 0 0 0 0 0 0 0 0 0 0 0 4 4 0 0 0 0 0 0 0 0 0 4 0 0 0 0 0 0 0 0 5 5 0 0 0 5 0 0 0 0 0 0 0 6 0 0 0 0 0 4 0 0 0 4 4 0 0 2 2 2 2 2 2
2 2 2 2 2 2 2 4 0 0 5 0 264 265 266 0 0 0 0 0 0 0 0 0 0 0 4 4 0 0 0 0 0 0 0 0 0 0 0 0 0 0 0 0 0 0 6 0 0 0 0 0 0 0 0 0 0 0 0 0 0 0 0 0 0 0 0 0 0 0 0 0 4 4 6 0 0 0 0 0 0 2 2 2 2 2 2
2 2 2 2 2 2 2 0 0 0 0 0 267 268 269 0 0 0 0 0 0 0 0 0 0 0 0 0 0 4 4 0 0 5 5 0 0 0 0 6 0 0 0 0 5 5 0 0 0 0 0 0 0 4 4 0 0 0 0 0 4 0 0 0 0 0 0 0 0 4 4 0 0 0 0 0 0 0 0 0 6 2 2 2 2 2 2
2 2 2 2 2 2 2 0 0 0 0 0 4 0 0 0 0 0 0 0 0 0 0 0 6 6 0 0 0 0 4 4 0 0 0 0 0 0 0 0 0 0 0 0 0 0 0 0 0 0 0 4 5 0 0 0 0 0 0 0 0 0 0 0 0 0 0 4 4 0 0 0 0 0 0 0 0 0 0 5 0 2 2 2 2 2 2
2 2 2 2 2 2 2 4 4 0 0 0 6 4 0 0 0 0 0 0 0 4 4 0 0 0 0 0 0 0 0 0 0 0 0 0 0 0 0 0 0 0 4 4 0 0 0 0 0 4 4 4 0 0 0 0 0 0 0 0 0 0 0 0 0 0 4 0 0 0 0 5 5 0 0 0 0 0 0 0 0 2 2 2 2 2 2
2 2 2 2 2 2 2 0 0 0 0 0 0 0 0 0 0 0 0 0 0 0 0 0 0 5 5 0 0 0 0 0 0 0 4 4 4 4 0 0 0 0 0 0 0 0 0 0 6 6 0 0 0 0 0 0 0 0 5 4 4 0 0 0 0 0 0 0 4 4 0 0 0 0 6 0 0 0 0 0 0 2 2 2 2 2 2
2 2 2 2 2 2 2 0 0 0 4 4 0 0 0 0 5 5 4 0 0 0 0 0 0 0 0 0 0 0 0 4 4 0 0 0 0 0 0 0 0 0 0 0 0 0 5 0 0 0 0 0 0 0 0 0 0 0 0 0 0 0 0 0 0 0 0 0 4 4 4 6 0 0 0 0 0 4 0 0 0 2 2 2 2 2 2
2 2 2 2 2 2 2 0 0 0 0 0 0 5 5 6 0 0 0 0 0 0 0 0 0 0 0 4 4 0 0 0 0 0 0 0 0 0 0 0 0 0 0 0 5 5 0 0 0 0 0 6 0 0 0 0 0 0 0 0 0 0 0 6 0 0 0 6 0 0 5 0 0 0 0 0 0 0 0 0 0 2 2 2 2 2 2
2 2 2 2 2 2 2 0 0 0 0 0 4 4 0 0 0 0 0 0 4 0 0 0 0 0 0 0 4 0 0 0 0 0 0 0 0 0 0 0 5 0 0 0 0 0 0 0 0 0 0 0 0 0 0 0 6 0 0 0 0 0 0 0 0 0 0 0 0 0 0 6 0 0 0 0 0 5 5 5 0 2 2 2 2 2 2
2 2 2 2 2 2 2 0 0 0 0 0 0 4 4 0 0 0 0 0 0 0 0 0 6 6 0 0 0 0 0 0 0 0 0 0 0 0 0 0 0 0 0 0 0 0 0 0 0 0 0 0 0 0 5 5 0 0 4 4 0 0 0 0 0 0 0 0 0 0 0 0 0 5 0 0 0 0 0 0 0 2 2 2 2 2 2
2 2 2 2 2 2 2 5 138 141 141 141 141 141 141 141 141 141 141 141 141 141 141 141 141 141 141 141 141 141 141 141 141 141 141 141 141 141 141 141 141 141 141 141 141 141 141 141 141 141 141 141 141 137 137 141 141 141 141 141 141 141 141 141 141 141 141 141 141 141 141 141 141 141 141 141 141 141 141 143 0 2 2 2 2 2 2
2 2 2 2 2 2 2 0 139 0 0 212 213 214 215 4 196 197 198 199 0 212 213 214 215 0 196 197 198 199 0 212 213 214 215 0 196 197 198 199 0 212 213 214 215 0 0 196 197 198 199 0 0 137 137 0 0 196 197 198 199 0 212 213 214 215 0 0 0 0 0 196 197 198 199 4 0 0 4 144 0 2 2 2 2 2 2
2 2 2 2 2 2 2 0 139 0 5 216 217 218 219 0 200 201 202 203 0 216 217 218 219 0 200 201 202 203 0 216 217 218 219 0 200 201 202 203 0 216 217 218 219 0 4 200 201 202 203 0 0 137 137 0 0 200 201 202 203 0 216 217 218 219 5 5 5 5 5 200 201 202 203 6 0 0 0 144 0 2 2 2 2 2 2
2 2 2 2 2 2 2 5 139 4 4 220 221 222 223 0 204 205 206 207 6 220 221 222 223 0 204 205 206 207 0 220 221 222 223 0 204 205 206 207 0 220 221 222 223 5 0 204 205 206 207 0 0 137 137 0 0 204 205 206 207 0 220 221 222 223 6 6 6 6 6 204 205 206 207 4 4 4 0 144 0 2 2 2 2 2 2
2 2 2 2 2 2 2 0 139 0 0 224 225 226 227 0 208 209 210 211 0 224 225 226 227 0 208 209 210 211 0 224 225 226 227 0 208 209 210 211 0 224 225 226 227 0 0 208 209 210 211 0 5 137 137 0 0 208 209 210 211 0 224 225 226 227 5 5 5 5 5 208 209 210 211 0 0 0 4 144 0 2 2 2 2 2 2
2 2 2 2 2 2 2 4 139 0 0 0 0 0 0 0 0 0 5 5 5 0 0 0 0 0 6 0 0 0 0 0 0 6 6 0 0 4 4 0 0 4 5 4 0 0 0 0 0 0 0 0 4 137 137 0 0 0 0 0 0 0 0 6 6 0 0 0 0 0 0 0 0 0 0 0 0 0 5 144 0 2 2 2 2 2 2
2 2 2 2 2 2 2 0 139 0 0 0 5 5 5 0 0 0 0 0 0 0 4 4 0 0 5 5 0 0 0 0 5 5 0 0 0 0 4 4 0 0 0 0 0 0 0 0 4 4 5 0 0 137 137 0 0 0 0 0 6 0 0 0 5 0 0 0 0 0 0 0 0 0 0 4 4 4 0 144 0 2 2 2 2 2 2
2 2 2 2 2 2 2 0 139 0 0 4 137 137 137 137 137 137 137 137 137 137 137 137 137 137 137 137 137 137 137 137 137 137 137 137 137 137 137 137 137 137 137 137 137 137 137 137 137 137 137 137 137 137 137 137 137 137 137 137 137 137 137 137 137 137 137 137 137 137 137 137 137 137 0 0 0 0 4 144 4 2 2 2 2 2 2
2 2 2 2 2 2 2 0 139 0 0 0 137 137 137 137 137 137 137 137 137 137 137 137 137 137 137 137 137 137 137 137 137 137 137 137 137 137 137 137 137 137 137 137 137 137 137 137 137 137 137 137 137 137 137 137 137 137 137 137 137 137 137 137 137 137 137 137 137 137 137 137 137 137 0 0 0 0 0 144 0 2 2 2 2 2 2
2 2 2 2 2 2 2 5 139 4 4 0 0 0 0 0 0 0 0 0 0 0 0 0 0 6 6 0 0 137 137 137 0 5 5 5 0 0 0 0 0 0 0 0 0 0 5 5 0 0 0 0 0 137 137 0 0 0 0 0 0 0 0 0 0 4 4 4 0 0 0 0 137 137 5 0 0 0 0 144 0 2 2 2 2 2 2
2 2 2 2 2 2 2 0 139 0 0 0 6 0 0 0 4 4 4 0 0 0 0 0 0 0 0 0 4 137 137 137 0 0 0 0 0 4 6 6 0 0 0 6 0 0 0 0 0 0 0 0 0 137 137 0 4 4 4 4 0 0 261 262 263 0 0 0 6 0 0 0 137 137 0 0 0 0 0 144 0 2 2 2 2 2 2
2 2 2 2 2 2 2 6 139 0 0 0 0 0 0 0 0 0 0 0 0 0 0 0 0 0 4 0 137 137 137 137 137 0 6 0 0 0 0 0 5 5 5 5 0 0 0 4 4 0 0 0 0 137 137 0 0 0 0 0 0 0 264 265 266 4 0 0 0 0 0 0 137 137 0 0 0 0 0 144 0 2 2 2 2 2 2
2 2 2 2 2 2 2 0 139 0 0 0 0 4 4 4 0 0 0 0 5 5 6 0 0 0 0 0 137 252 253 254 137 0 0 5 0 0 0 0 0 4 4 0 0 0 0 0 0 6 5 0 0 137 137 0 0 4 4 4 4 0 267 268 269 0 4 4 0 0 0 0 137 137 0 0 0 0 4 144 5 2 2 2 2 2 2
2 2 2 2 2 2 2 0 139 0 0 228 229 230 231 232 233 4 0 0 0 0 0 0 0 0 0 0 137 255 256 257 137 0 0 5 5 5 0 0 0 6 4 4 4 4 4 0 0 0 0 0 0 137 137 0 0 0 0 0 0 0 4 5 6 4 4 0 0 0 0 0 137 137 0 0 0 0 6 144 0 2 2 2 2 2 2
2 2 2 2 2 2 2 5 139 0 0 234 235 236 237 238 239 0 0 0 0 0 0 0 0 0 4 0 137 258 259 260 137 0 0 0 0 0 0 0 5 5 0 0 0 0 0 0 0 0 0 0 5 137 137 0 0 0 0 0 0 0 0 0 0 0 0 0 0 0 0 0 137 137 0 0 0 0 0 144 0 2 2 2 2 2 2
2 2 2 2 2 2 2 5 139 0 0 240 241 242 243 244 245 0 0 0 0 0 0 5 5 137 137 137 137 137 137 137 137 137 137 137 137 137 137 137 137 137 137 137 137 137 137 137 137 137 137 137 137 137 137 137 137 137 137 137 137 137 137 137 137 137 137 137 137 137 137 137 137 137 0 0 4 0 0 144 4 2 2 2 2 2 2
2 2 2 2 2 2 2 0 139 0 0 246 247 248 249 250 251 0 0 0 0 4 4 4 0 137 137 137 137 137 137 137 137 137 137 137 137 137 137 137 137 137 137 137 137 137 137 137 137 137 137 137 137 137 137 137 137 137 137 137 137 137 137 137 137 137 137 137 137 137 137 137 137 137 0 0 0 0 0 144 0 2 2 2 2 2 2
2 2 2 2 2 2 2 4 139 6 0 0 0 0 0 0 0 0 0 0 0 0 0 0 0 0 0 0 0 0 0 0 4 4 0 0 0 0 0 0 0 0 0 0 0 0 0 0 0 0 0 0 0 0 0 4 4 4 0 0 0 0 0 0 0 0 0 0 4 4 0 0 0 0 0 0 0 0 0 144 0 2 2 2 2 2 2
2 2 2 2 2 2 2 0 139 0 0 0 0 0 4 4 4 4 0 0 0 0 0 5 5 0 0 0 0 0 0 0 0 0 0 0 0 0 0 6 6 0 0 0 0 0 0 0 5 5 0 0 0 0 0 5 5 6 0 0 0 0 0 0 0 0 0 0 0 0 0 0 4 4 5 0 0 0 0 144 0 2 2 2 2 2 2
2 2 2 2 2 2 2 6 139 0 0 0 0 0 0 0 0 0 0 0 0 0 0 6 0 0 0 0 0 0 0 0 0 0 0 5 5 0 0 0 0 0 0 0 6 6 0 0 0 0 0 0 0 0 0 0 0 0 0 0 6 6 4 0 0 0 0 0 0 0 0 0 0 4 4 0 0 0 0 144 0 2 2 2 2 2 2
2 2 2 2 2 2 2 0 140 141 141 141 141 141 141 141 141 141 141 141 141 141 141 141 141 141 141 141 141 141 141 141 141 141 141 141 141 141 141 141 141 141 141 141 141 141 141 141 141 141 141 141 141 141 141 141 141 141 141 141 141 141 141 141 141 141 141 141 141 141 141 141 141 141 141 141 141 141 141 142 0 2 2 2 2 2 2 
2 2 2 2 2 2 2 73 73 74 73 73 73 73 74 73 73 74 74 74 74 73 73 73 73 73 73 73 73 73 73 73 74 74 73 73 73 73 73 73 73 73 73 73 74 74 73 73 73 73 73 73 73 73 73 73 73 73 74 74 74 73 73 73 73 74 74 73 73 73 73 73 73 73 73 73 73 73 73 73 73 2 2 2 2 2 2
2 2 2 2 2 2 2 2 2 2 2 2 2 2 2 2 2 2 2 2 2 2 2 2 2 2 2 2 2 2 2 2 2 2 2 2 2 2 2 2 2 2 2 2 2 2 2 2 2 2 2 2 2 2 2 2 2 2 2 2 2 2 2 2 2 2 2 2 2 2 2 2 2 2 2 2 2 2 2 2 2 2 2 2 2 2 2
2 2 2 2 2 2 2 2 2 2 2 2 2 2 2 2 2 2 2 2 2 2 2 2 2 2 2 2 2 2 2 2 2 2 2 2 2 2 2 2 2 2 2 2 2 2 2 2 2 2 2 2 2 2 2 2 2 2 2 2 2 2 2 2 2 2 2 2 2 2 2 2 2 2 2 2 2 2 2 2 2 2 2 2 2 2 2
2 2 2 2 2 2 2 2 2 2 2 2 2 2 2 2 2 2 2 2 2 2 2 2 2 2 2 2 2 2 2 2 2 2 2 2 2 2 2 2 2 2 2 2 2 2 2 2 2 2 2 2 2 2 2 2 2 2 2 2 2 2 2 2 2 2 2 2 2 2 2 2 2 2 2 2 2 2 2 2 2 2 2 2 2 2 2
2 2 2 2 2 2 2 2 2 2 2 2 2 2 2 2 2 2 2 2 2 2 2 2 2 2 2 2 2 2 2 2 2 2 2 2 2 2 2 2 2 2 2 2 2 2 2 2 2 2 2 2 2 2 2 2 2 2 2 2 2 2 2 2 2 2 2 2 2 2 2 2 2 2 2 2 2 2 2 2 2 2 2 2 2 2 2
2 2 2 2 2 2 2 2 2 2 2 2 2 2 2 2 2 2 2 2 2 2 2 2 2 2 2 2 2 2 2 2 2 2 2 2 2 2 2 2 2 2 2 2 2 2 2 2 2 2 2 2 2 2 2 2 2 2 2 2 2 2 2 2 2 2 2 2 2 2 2 2 2 2 2 2 2 2 2 2 2 2 2 2 2 2 2
2 2 2 2 2 2 2 2 2 2 2 2 2 2 2 2 2 2 2 2 2 2 2 2 2 2 2 2 2 2 2 2 2 2 2 2 2 2 2 2 2 2 2 2 2 2 2 2 2 2 2 2 2 2 2 2 2 2 2 2 2 2 2 2 2 2 2 2 2 2 2 2 2 2 2 2 2 2 2 2 2 2 2 2 2 2 2